{
	"data"	:	[
		[9,	10,	0,	0,	0,	0,	0,	8,	9,	9,	9,	9,	10,	18,	12,	13,	13,	3,	9,	9,	9,	9,	9,	9,	9],
		[7,	14,	0,	0,	0,	0,	0,	8,	9,	9,	7,	13,	14,	0,	0,	0,	0,	12,	13,	13,	3,	9,	9,	9,	9],
		[10,0,	0,	0,	0,	0,	0,	8,	9,	7,	14,	0,	0,	0,	0,	0,	0,	0,	0,	0,	12,	3,	9,	9,	9],
		[11,5,	6,	0,	0,	0,	0,	8,	9,	10,	0,	0,	0,	0,	0,	0,	0,	0,	0,	0,	0,	12,	3,	9,	9],
		[9,	9,	10,	0,	0,	0,	0,	12,	13,	14,	0,	0,	0,	0,	0,	0,	0,	0,	0,	0,	0,	0,	12,	3,	9],
		[7,	13,	14,	0,	0,	0,	0,	0,	0,	0,	0,	0,	0,	0,	0,	0,	0,	0,	0,	0,	0,	0,	0,	8,	9],
		[14,0,	0,	0,	0,	0,	0,	0,	0,	0,	0,	0,	0,	0,	0,	0,	0,	0,	0,	0,	0,	0,	0,	12,	9],
		[0,	0,	0,	0,	0,	0,	2,	0,	0,	0,	0,	0,	0,	0,	0,	0,	0,	0,	0,	0,	0,	0,	0,	0,	8],
		[0,	0,	0,	0,	0,	0,	0,	0,	0,	0,	0,	0,	0,	0,	0,	0,	0,	0,	0,	0,	2,	0,	0,	0,	8],
		[0,	0,	0,	0,	0,	0,	0,	0,	0,	0,	0,	0,	0,	0,	0,	0,	0,	0,	0,	0,	0,	0,	0,	0,	12],
		[0,	0,	0,	0,	0,	0,	0,	0,	0,	0,	0,	0,	0,	0,	0,	0,	0,	0,	0,	0,	0,	0,	0,	0,	0],
		[1,	0,	0,	0,	0,	0,	0,	0,	0,	0,	0,	0,	0,	0,	0,	1,	0,	0,	0,	0,	0,	0,	0,	0,	0],
		[0,	0,	0,	0,	0,	0,	0,	0,	0,	0,	0,	0,	0,	0,	0,	0,	0,	0,	0,	0,	0,	0,	0,	0,	0],
		[0,	0,	0,	0,	0,	4,	5,	6,	0,	0,	0,	0,	0,	0,	0,	0,	0,	0,	0,	0,	0,	0,	0,	0,	17],
		[0,	0,	0,	4,	5,	15,	9,	11,	5,	6,	0,	0,	0,	0,	0,	0,	0,	0,	0,	0,	0,	0,	0,	0,	0],
		[0,	0,	0,	12,	9,	9,	9,	9,	9,	10,	0,	0,	0,	0,	0,	0,	0,	0,	0,	0,	0,	0,	0,	0,	0],
		[0,	0,	0,	0,	12,	13,	3,	9,	9,	10,	0,	0,	0,	0,	0,	0,	0,	0,	0,	0,	0,	0,	0,	0,	0],
		[0,	0,	0,	0,	0,	0,	12,	13,	13,	14,	0,	0,	0,	0,	0,	0,	0,	0,	0,	0,	1,	0,	0,	0,	0],
		[0,	0,	0,	0,	0,	0,	0,	0,	0,	0,	0,	0,	0,	0,	0,	0,	0,	0,	0,	0,	0,	0,	0,	0,	0]
	]
}