{
	"data" : [
		[9,	9,	9,	9,	10,	0,	0,	0,	0,	0,	0,	0,	0,	0,	0,	18,	0,	0,	0,	0,	0,	0,	0,	0,	1],
		[9,	9,	9,	7,	14,	0,	0,	0,	0,	0,	4,	5,	5,	5,	5,	5,	5,	5,	5,	5,	5,	6,	0,	0,	0],
		[9,	9,	9,	10,	0,	0,	0,	0,	0,	4,	9,	9,	7,	13,	13,	3,	9,	9,	9,	9,	9,	11,	6,	0,	0],
		[9,	9,	9,	10,	0,	0,	0,	0,	4,	9,	7,	13,	14,	0,	0,	12,	13,	13,	13,	13,	13,	3,	9,	6,	0],
		[9,	9,	9,	10,	0,	0,	0,	0,	9,	9,	14,	0,	0,	0,	0,	0,	0,	0,	0,	0,	0,	12,	3,	10,	0],
		[9,	9,	9,	10,	0,	0,	0,	4,	7,	14,	0,	0,	0,	4,	5,	5,	5,	5,	6,	0,	0,	0,	8,	10,	0],
		[9,	9,	9,	9,	6,	0,	0,	8,	10,	0,	0,	0,	4,	9,	7,	13,	13,	13,	3,	6,	0,	0,	8,	11,	6],
		[9,	9,	9,	9,	10,	0,	0,	8,	10,	0,	0,	0,	8,	9,	10,	0,	0,	0,	8,	10,	0,	0,	12,	3,	10],
		[9,	9,	9,	9,	10,	0,	0,	12,	11,	0,	0,	0,	12,	13,	14,	0,	0,	0,	8,	10,	0,	0,	0,	8,	10],
		[13,13,	3,	9,	11,	6,	0,	0,	8,	6,	0,	0,	0,	0,	0,	0,	0,	0,	8,	10,	0,	0,	0,	8,	10],
		[0,	0,	8,	9,	9,	10,	0,	0,	8,	11,	6,	0,	0,	0,	0,	0,	0,	4,	7,	14,	0,	0,	4,	15,	10],
		[0,	0,	12,	3,	9,	10,	0,	0,	12,	3,	11,	5,	6,	0,	0,	0,	4,	9,	10,	0,	0,	0,	8,	9,	10],
		[0,	0,	0,	8,	9,	11,	6,	0,	0,	12,	13,	3,	9,	5,	5,	5,	15,	9,	14,	0,	0,	0,	8,	9,	10],
		[19,	0,	0,	12,	3,	9,	11,	6,	0,	0,	0,	12,	13,	13,	13,	13,	13,	14,	0,	0,	0,	4,	15,	7,	14],
		[0,	0,	0,	0,	12,	3,	9,	11,	6,	0,	0,	0,	0,	0,	0,	0,	0,	0,	0,	0,	4,	15,	9,	10,	0],
		[0,	0,	0,	0,	0,	12,	3,	9,	11,	5,	5,	5,	5,	5,	5,	5,	5,	5,	5,	5,	15,	9,	7,	14,	0],
		[0,	1,	0,	0,	0,	0,	12,	13,	3,	9,	9,	9,	9,	9,	9,	9,	9,	9,	9,	9,	7,	13,	14,	0,	0],
		[0,	0,	0,	0,	0,	0,	0,	0,	12,	13,	13,	13,	13,	13,	13,	13,	13,	13,	13,	13,	14,	0,	0,	0,	0],
		[0,	0,	0,	0,	0,	0,	0,	0,	0,	0,	0,	0,	0,	0,	0,	0,	0,	0,	0,	0,	0,	0,	0,	2,	0]
	]
}