{
	"data"	:	[
		[0,	0,	0,	0,	0,	0,	0,	0,	0,	0,	1,	0,	0,	12,	3,	9,	9,	9,	9,	9,	9,	9,	9,	9,	9],
		[0,	0,	1,	0,	0,	0,	0,	0,	0,	0,	0,	0,	0,	0,	12,	13,	13,	13,	3,	9,	9,	9,	9,	9,	9],
		[0,	0,	0,	0,	0,	0,	0,	0,	0,	0,	0,	0,	0,	0,	0,	0,	0,	0,	12,	3,	9,	9,	9,	9,	9],
		[0,	0,	0,	0,	4,	5,	6,	0,	0,	0,	0,	0,	0,	0,	0,	0,	0,	0,	0,	12,	13,	3,	9,	9,	9],
		[0,	0,	0,	4,	15,	9,	11,	6,	0,	0,	0,	0,	0,	0,	0,	0,	0,	1,	0,	0,	0,	12,	3,	9,	9],
		[0,	0,	4,	15,	9,	9,	9,	11,	6,	0,	0,	0,	0,	0,	0,	0,	0,	0,	0,	0,	0,	0,	8,	9,	9],
		[0,	4,	15,	9,	7,	13,	3,	9,	11,	6,	0,	0,	0,	0,	0,	0,	0,	0,	0,	0,	0,	0,	12,	3,	9],
		[4,	15,	9,	7,	14,	0,	12,	3,	9,	11,	6,	0,	0,	0,	0,	0,	0,	0,	0,	0,	0,	0,	0,	12,	13],
		[8,	9,	9,	10,	0,	0,	0,	8,	9,	9,	10,	0,	0,	0,	0,	0,	0,	0,	0,	0,	0,	0,	0,	0,	0],
		[12,3,	9,	11,	6,	0,	4,	15,	9,	7,	14,	0,	0,	0,	0,	0,	0,	0,	0,	0,	0,	1,	0,	0,	17],
		[0,	12,	3,	9,	11,	5,	15,	9,	7,	14,	0,	0,	0,	0,	0,	0,	0,	0,	0,	0,	0,	0,	0,	0,	0],
		[0,	0,	12,	3,	9,	9,	9,	7,	14,	0,	0,	0,	0,	0,	0,	0,	0,	0,	0,	0,	0,	0,	0,	4,	5],
		[0,	0,	0,	12,	3,	9,	7,	14,	0,	0,	0,	0,	1,	0,	0,	0,	0,	0,	0,	0,	0,	0,	4,	15,	9],
		[0,	0,	0,	0,	12,	13,	14,	0,	0,	0,	0,	0,	0,	0,	0,	0,	0,	0,	0,	0,	0,	0,	8,	9,	9],
		[0,	0,	0,	0,	0,	0,	0,	0,	0,	0,	0,	0,	0,	0,	0,	0,	0,	2,	0,	0,	0,	4,	15,	9,	9],
		[0,	0,	0,	0,	0,	0,	0,	0,	0,	0,	0,	0,	4,	5,	6,	0,	0,	0,	0,	0,	0,	8,	9,	9,	9],
		[6,	0,	0,	0,	0,	0,	0,	0,	0,	0,	0,	0,	12,	3,	11,	6,	0,	0,	0,	4,	5,	15,	9,	9,	9],
		[10,0,	2,	0,	0,	0,	0,	0,	0,	4,	5,	6,	0,	12,	3,	11,	5,	5,	5,	15,	9,	9,	9,	9,	9],
		[11,6,	0,	1,	0,	0,	0,	4,	5,	15,	9,	11,	6,	16,	8,	9,	9,	9,	9,	9,	9,	9,	9,	9,	9]
	]
}