{
	"data"	:	[
		[9,	9,	9,	9,	9,	9,	9,	9,	9,	9,	9,	9,	9,	9,	9,	9,	10,	0,	0,	0,	0,	0,	0,	0,	0],
		[9,	9,	9,	9,	9,	9,	9,	9,	7,	13,	3,	9,	9,	9,	9,	9,	11,	5,	6,	0,	2,	0,	0,	0,	0],
		[9,	9,	9,	9,	9,	9,	7,	13,	14,	0,	12,	13,	13,	3,	9,	9,	9,	9,	10,	0,	0,	0,	0,	0,	0],
		[9,	9,	9,	7,	13,	13,	14,	0,	0,	0,	0,	0,	0,	12,	3,	9,	9,	9,	11,	6,	0,	0,	0,	0,	0],
		[9,	9,	7,	14,	0,	0,	0,	0,	0,	0,	0,	0,	0,	0,	8,	9,	9,	9,	9,	14,	0,	0,	0,	0,	0],
		[9,	7,	14,	0,	0,	1,	0,	0,	0,	0,	0,	0,	0,	0,	8,	9,	9,	7,	14,	0,	0,	0,	0,	0,	0],
		[9,	10,	0,	0,	0,	0,	0,	0,	0,	0,	0,	0,	0,	0,	8,	9,	9,	10,	0,	0,	0,	0,	0,	0,	4],
		[13,14,	0,	0,	0,	0,	0,	0,	0,	0,	0,	0,	0,	4,	15,	9,	9,	10,	0,	0,	0,	0,	0,	4,	15],
		[0,	0,	0,	0,	0,	0,	0,	0,	0,	0,	1,	0,	0,	8,	9,	9,	9,	11,	6,	0,	0,	0,	4,	15,	9],
		[19,	0,	0,	0,	0,	0,	0,	0,	0,	0,	0,	0,	4,	15,	9,	7,	13,	3,	10,	0,	0,	0,	8,	9,	9],
		[0,	0,	0,	0,	0,	0,	0,	4,	5,	5,	5,	5,	15,	9,	9,	10,	0,	8,	11,	5,	5,	5,	15,	9,	9],
		[5,	5,	5,	5,	5,	5,	5,	9,	9,	9,	9,	9,	9,	9,	9,	11,	5,	15,	9,	9,	9,	9,	9,	9,	9],
		[9,	9,	9,	9,	9,	9,	9,	9,	9,	9,	9,	7,	13,	3,	9,	9,	9,	9,	9,	9,	9,	9,	9,	9,	9],
		[9,	9,	9,	9,	9,	9,	9,	7,	13,	13,	13,	14,	0,	12,	3,	9,	9,	7,	13,	13,	13,	3,	9,	9,	9],
		[9,	9,	9,	9,	9,	7,	13,	14,	0,	0,	0,	0,	0,	0,	12,	13,	13,	14,	0,	0,	0,	12,	3,	9,	9],
		[9,	9,	9,	7,	13,	14,	0,	0,	0,	0,	0,	0,	0,	0,	0,	0,	0,	0,	0,	0,	0,	0,	8,	9,	9],
		[9,	9,	9,	10,	0,	0,	0,	0,	0,	0,	0,	0,	0,	0,	0,	0,	0,	0,	0,	0,	0,	0,	12,	13,	3],
		[9,	9,	9,	10,	0,	0,	0,	0,	0,	0,	1,	0,	0,	0,	0,	0,	0,	0,	0,	0,	0,	0,	0,	0,	12],
		[9,	9,	9,	11,	6,	0,	0,	0,	0,	0,	0,	0,	0,	0,	0,	16,	0,	0,	0,	0,	0,	0,	0,	0,	0]
	]
}